0001111111000000
0001000010100000
0001100011100000
0001000010100000
0000000000000000
0000111111001000
0001000001111000
0000111111110000
0001111111001000
1111111111111111
0001010001001000
0001111111110000
0001000000000000
1111111111110000
0011100001001000
0001000000110000
0001000000000000