0001000000000000
0001111111111111
1111100010100000
0001000010100000
0001000010100000
1111111111111111
0000000000000111
0000000000000111
1111111111111111
0000011111100000
0000011111100000
0000100000010000
0000100000010000
0000100000010000
0000100000010000
1111000000001111