999999999999999999999999999999999999999999999
933002000004400000001111000000000011000000009
930002000444400000001100000000000011000000009
900002004333400000111100000000000011000000009
930002043003333333333333333333333311110000009
900002000003333333333333333333333311110000009
900002000013322211331111111111113333333311229
900000000013300011331111111111113333333311229
930000000013333311333333333322223333112011009
944400000003333311333333333300003333112011009
944400000000003333110000333333333333110011009
944430000000003333112222333333333333110011009
944433011000001111111111111111333311111033339
911100011000001111111111111111333311111033339
900000000000022211110000330000001111000000339
900000000000020011110000440000001100000000339
900000022200001100110000440000001133331110339
900000000000001100110000000022110033331110339
922000000000001100000000000111113333110000339
930000000000001100000000000111003333110000339
900000000011111111110033300111333300331133339
900000000011111111110033300100333311331133339
900033000000110000000000003300000011331133009
900330000100110000111110003300000011330033009
900000000100000000100010000000440000333333009
900000000100000000108010000000440000333333009
999999999999999999999999999999999999999999999