0000000000000000
0001111111100000
0001110011100000
0001110010100000
0001110010100000
1111111111111111
0000000000000000
0000000000000000
0001111111111000
1111111111111111
0001010000110000
0001110001001000
0001010000110000
0000000000110000
000100000110100
0001000001111000
0001110001001000