000000000000000000000000000000000000000010000100
000111111110000000000000000000000000000010000000
000111001110000000000000000010110011011010101010
000111001010000000011100101000000001110010100000
000111001010000000011100101000000001110010100000
111111111111111111111111111111111111111111111111
000000000000000000000000000000000000000000000000
000000000000000000000000000000000000000000000000
000111111111100000011111111110000001111111111000
111111111111111111111111111111111111111111111111
000101000011000000010100001100000001010000110000
000111000100100000011100010010000001110001001000
000101000011000000010100001100000001010000110000
000000000000000000000000000000000000000000000000
000000000011000000000000001100000000000000110000
000100000100100000010000010010000001000001001000
000100000111100000010000011110000001000001111000
000111000100100000011100010010000001110001001000