999999999999999999999999999999999999999999999
933333330000000000000000000000000333333333339
933333303000000000000000000000003000003333339
933333000333000000044400000003330000000333339
933330000333000000144410000003330000000033339
933300000333000001100011000003330000000000339
933000000000300011000001100030000000000000039
930020000200030110000000110300020000002000009
922221001222221100000000011222221100112222229
900020000200011000000000001100020000002000009
900000000000110000003000000110000000000000009
911000000001100000033300000011000000000000009
901100000044000000344430000004400000000000009
980110000044000003344433000004400000000000009
901100000044000000344430000004400000000000009
911000000001100000033300000011000000000000009
900000000000110000003000000110000000000000009
900020000200011000000000001100020000002000009
922221001222221100000000011222221100112222229
930020000200030110000000110300020000002000039
933000000000300011000001100030000000000000339
933300000333000001100011000003330000000003339
933330000333000000144410000003330000000033339
933333000333000000044400000003330000000333339
933333303000000000000000000000003000003333339
933333330000000000000000000000000333333333339
900000000000000000000000000000000000000000009
999999999999999999999999999999999999999999999

