999999999999999999999999999999999999999999999
900000000000000000003333000000000000000000009
900000000000000000003333000000000000000000009
900000020000000000003333000000000000002330009
900000020000000000000000000000000000002333009
900000020001111111001111000011111000002333009
900000020001111111001131100011311000002330009
900000010000011100001133110011311000002000009
900000000000011100001144110011111000002000009
911100000000011100001133110011111000002000009
900100020000011100001131100011000000001000009
980100020000011100101111001011000000001000009
900100020000000000000000000000000000002000009
911100020444333334433333344333333300002000009
900000000000000000000000000000000000002000009
900000000000000000000000000000000000000000009
900000010000111110001111100110011111000000009
900000020000000010001333100010010000002000009
911111120000000010001343100010010000002111119
900000020000111110001343100010011111002000009
900000020000100000001343100010013331002000039
930000020000100000001333100010013331002003339
933330020000111110001111100010011111002033339
933330000000000000000000000000000000000033339
933333000000000000000000000000000000000033339
933333300000000000000000000000000000000333339
900000000000000000000000000000000000000000009
999999999999999999999999999999999999999999999

