000000002000000000000000000000000000000000000000
000000002000000000000000000000000000000000000000
000000002000000000000000000000000000000000000000
000000002000000000000000000000000000000000000000
000000001111111111111111110000000000000000000000
000000001000000000000220010000000000000000000000
000000001000000000000220010000000000000000000000
000000001000000300000000010000000000000000000000
000000001000000333000000010000000000000000000000
000000001000000333000200010000000000000000000000
000000001000000000000220010000000000000000000000
000000001440000000000000010000000000000000000000
000000001444000000000000010000000000000000000000
000000001111111111111111110000000000000000000000
000000000000000000000000000000000000000000000000
000000000000000000000000000000000000000000000000
000000000000000000000000000000000000000000000000
000000000000000000000000000000000000000000000000