000000000000000000000000000000000000000000000000
000000000000000000000000000000000000000000000000
000000000000000000000000000000000000000000000000
000000000000000000000000000000000000000000000000
000000001111111111111111110000000000000000000000
000000001000000000000110010000000000000000000000
000000001000000000000110010000000000000000000000
000000001000000000000000010000000000000000000000
000000001000000000000000010000000000000000000000
000000001000000000000100010000000000000000000000
000000001000000000000110010000000000000000000000
000000001000000000000000010000000000000000000000
000000001000000000000000010000000000000000000000
000000001111111111111111110000000000000000000000
000000000000000000000000000000000000000000000000
000000000000000000000000000000000000000000000000
000000000000000000000000000000000000000000000000
000000000000000000000000000000000000000000000000