999999999999999999999999999999999999999999999999
900000000200000000000000000000000000000000000009
900000000200000000000000000000000000000000000009
900000000200000000000000000000000000000000000009
900000001111111111111111110000000000000000000009
900000001000000000000220010000000000000000000009
900500001000000000000220010000000000000000000009
900000001000000300000000010000000000000000000009
900000001000000333000000010000000000000000000009
900000001000000333000200010000000000000000000009
900000001000000000000220010000000000000000000009
900000001440000000000000010000000000000000000009
900000001444000000000000010000000000000000000009
900000001111111111111111110000000000000000000009
900000000000000000000000000000000000000000000009
900000000000000000000000000000000000000000000009
900000000000000000000000000000000000000000000009
999999999999999999999999999999999999999999999999